###################
#........#........#
#o##.###.#.###.##o#
#.................#
#.##.#.#####.#.##.#
#....#...#...#....#
####.###.#.###.####
   #.#.......#.#
####.#.##-##.#.####
(   ...# ^ #...   )
####.#.#####.#.####
   #.#.......#.#
####.#.#####.#.####
#........#........#
#o##.###.#.###.##o#
#..#.....e.....#..#
##.#.#.#####.#.#.##
#....#...#...#....#
#.######.#.######.#
#.................#
###################
